1111111111111111
1000000000000001
1000000000C00001
1000000000000001
10000000E0000001
1010000000000001
10000000P0000001
1111111111111111
