1111111110
1111000010
10000P0010
1000011110
1111111110
