01111110
1000E001
100000C1
10000001
1P000001
01111110
