1111111
1111111
1111C11
1111011
1111E11
1111P11
1111111
1111111
