11111111111111111
100000000000000111
