111111
E1111E
011110
011110
011111
P11111
111111
000000
000000
