111111111111
1P00C0000111
100000000001
100E0000C000
111111111111
