1111111110
1C11100010
1000P00010
10E0011110
1111111110
