111111
11111E
111110
111110
11111P
111111
000000
000000
