11111111101
110C0001101
1000C00E101
1P000000101
11000001101
11111111101
