111111
E1111E
011110
011110
011111
111111
111111
000000
00000P
