111111111
111100001
10C0P0001
1CEC01111
111111111
000000000
