111111111
111C10011
1001C00E1
1P0000001
110000011
111111111
