111111
111101
111101
1111E1
1111X1
111111
