111111111
111100001
100E00001
100001111
111111111
