11111111111111111
100E0000000P000111
