111111111
110000011
1000001E1
1P0000011
110000011
111111111
