1111111111111111111111
110000001E100000000011
1110C000000000000001C1
1110000000000000000101
1110000000000000000101
11C1000000000000000001
110000000001P100000001
1111111111111111111111
