01111110
1000E001
10000001
10000001
1P000001
01111110
