111111111
11110E001
1P00000E1
100001111
111111111
