0111111111
01111000C1
01000P0001
010E001111
0111111111
