000000000
111111111
111100001
1000P0001
10E001111
111111111
