0111111111
0111100001
01000P0001
010E001111
0111111111
