1111111111
110C000111
1000C00E11
1P00000011
1100000111
1111111111
