11111111
100000P1
10000101
11001111
11E00011
11111111
