11111111111
10000000001
10000E00001
10000000001
10000000001
1P000000001
11111111111
