111111111111111111111111111111111111111111111111111111111111111111111111111111
1000E000000P000000000C00000000000000000000000000000000000000000000000000000001
111111111111111111111111111111111111111111111111111111111111111111111111111111
