111111111
111100001
100000001
100001111
111111111
